----------------------------------------------------------------------------------------------------------------------------------------------------------------------------------------------------
----------------------------------------------------------------------------------------------------------------------------------------------------------------------------------------------------
----------------------------------------------------------------------------------------------------------------------------------------------------------------------------------------------------
----------------------------------------------------------------------------------------------------------------------------------------------------------------------------------------------------
------------------------------------------------------------------------------------------------------------------SS--------------------------------------------------------------------------------
-----S-S----------------------------------------------------------------------------------------------------------SS-----------------------S---------------------------SS---------------------------
-----------------------X-----------------------------------------------------------------------------------------------------------------------------------------------------------------------<<---
---X-----XXXXX--------------------------------------------------------------------------------------------------------------------------------------------------------------------------------------
-----------------------S--------------------------------------------S---------------------------------------E--------------ES-S--E---------------------------XXX------------------------E------S----
QQQ------------------------------------E-----<----E--------------------------------------------------------E--------------X>----X>>----E-----------------------------------------------XXX------S-S-
--------------------------E-----E-----<>-----[---<>----------------------------[--------------------------<>--------------[]----[]]---<----------------X-XXXXXXX----------------------XXXX----------
-------------------------------<>-----[]-----[---[]-------------------------------------------------------[]--------------[]----[]]---[----------------X-XXXXXXX----------------------XXXX------EX--
----------E---------------------]--EE-[E--E--[]--[]---------E--EE---E-E------E-E-----E--EX-EE---E-E-----E-[]-----------EEE[]E-E-[[]E-------E------XXXXXXXXXXXXXX--E-EX------E---------XXXX------EX--
X-----XX--XXXX------XXXXXXXXXXXXXXXX-XXXXXXXXXXXXXXXXXXXXXXXXXXXXXXX--XXXXXXXXXXXXXXXXXX---XXXXX--XXXXXXXXXXXXXXXXXXXX---XXXXXXXXXXXXXXXXXXXXXXXXXXXXXXXXXXXXXXXXXXXXXXXXXXXXXXXXXXXXXX---XXXXXXXXXX
