----------------------------------------------------------------------------------------------------------------------------------------------------------------------------------------------------
----------------------------------------------------------------------------------------------------------------------------------------------------------------------------------------------------
-SSSSSSSSSSSSSSSSSSSSSSSSSSS------------------------------------------------------------------------------------SSSSSSSSSSSSSSSSSSSSSSSSSSSS--------------------------------------------------------
----------------------------------------------------------------------------------------------------------------------------------------------------------------------------------------------------
------------XXX----------------------------------------------S--------------------------------------------------------------------------------------------------------------------------------------
-----------------------------------------------------------SSSSS---------------------------------------------------------------------SSSS---S-------------------------------------------------------
----------------------------------------------------------------E----X-------------------------------------------------------------------------------------------X-X--------------------------------
--------------------------------------------------------------E-------------------------------------------------SS----------------------------------------------------------------------------------
------------------------E---------------S-----------E-------------S-------<E------E-----------------------------S---------SS------------X-X-----------------EX--------------------------------------
-----------------------E------E-----S--------------[>-----XXX---XX---------]-----<XX----------------------EE----E--------X------SSSSS---XX-XS--------------XXX------S--------------------------E----
----------------------<>-----<>-----S--------[-----[]------E----------------------X----------------------<>----->--E--------------------XXX----------------XXX--------E-----------------------<>----
----------------------[]-----[]--------------[-----[]----------------------------[]----------------------[]-----]----------XXX--------XXXXX---------------XXXX--------------------------------[]----
-E-EE--EE---E-E--E-EE-[]-----[]----EE--E--E--[]----[--------------XX-------------[]--------EE---E-E------[]-----]--E-------X----------XXXXX-----E---------XXXX------------------E---E-E-----E-[]----
XX-X-X-XXXXX--XXXXXX--<XXXXXXXXXXX---XXXXXXXXXXXXXXXXXXX------XXX---XXXXXX----XXXX--XXXXXXXXXXXX--XXXXXXXXXXXXXXXX-QXXXXXXX-X-XXXXXXXXXXXX-XXXXXXXXXXXXXXXXXXXXXXXXXXXXXXXXXXX--XXXX--XXXXXXXXXXXXX-
