--------------------------------------------------------------------------------------------------------X-------------------------------------------------------------------------------------------
--------------------------------------------------------------------------------------------------------]-------------------------------------------------------------------------------------------
------------------------------------------------------------------------------------------------S--S--------X---------------------------------------------------------------------------------------
----------------------------------------------------------------------------------------------------------------------------------------------------------------------------------------------------
-----------------------------------------------------------------------------------------------------------------------------X----------------------------------------------------------------------
-S-----------------------------------------------------------------------X----------SSS---Q---------XXX-----QQQS--------------------------------------------------SS--------SSSSSS-S------SSSSSSS---
------------------------------------------------<X----------------------------------------<--------SXXXX---<<---------------------------------------E-----------------------------------------------
---------------------------------------------------------------------------------------------------XXX--------S-------------------------------------------------------------------------------------
----------------E------S-S------------------E----------------------------------S-S-E-<X------------XXX-----S-S------------S---------------E-S---------SS------------X---E---------------------------
------S---------XX------S-------------E----X----------------------------------------------XX-----XXXXX------S-S---XXX--------------------XXXE--X-----X---------S-----X--E----E-SXS--------QSS-------
---------------XXX-------------------<>----XX---------E----------------XX-----------------XX---XXXXXXX-----------------------------------XX->--E---------------------XX->---->--------------------E-
------X-------XXXXXXXX--EX-----------[]---X-----------EX-------------------------X--------XX---XXXXXXX------EX---------------------------[]-]------------------------XX-]---[]----------------------
----E-X--------XXX------EX------E----[]-----E---------------E-------------------E---X-----XX-XXXXXXXX-------EX---E-E----------------EE---[]-]E-E-----------------XX--[]-XX--[]----------------------
XXXXXXXX----XXXX---------XXXXXXXXXXXXXXXXXX--XXXXXXXXXXXXXX--XXX---XXX------XXXXXXXXXXXXXXXXXXXXXXXXX---XXXXXXXXXX-XXXXXXXXXXXXXXXXXXXXXXX--XX-XXXXXXXXXXXXXXXXXXXXXXX--XXXXXXXXXXXXXXXXXXXXXXXXXXXX
