----------------------------------------------------------------------------------------------------------------------------------------------------------------------------------------------------
----------------------------------------------------------------------------------------------------------------------------------------------------------------------------------------------------
----------------------------------------------------------------------------------------------------------------------------------------------------------------------------------------------------
----------------------------------------------------------------------------------------------------------------------------------------------------------------------------------------------------
----------------------------------------------------------------------------------------------------------------------------------------------------------------------------------------------------
------------------------E-E-------------------------E-E-------------------------E-E-------------------------E-E-------------------------E-E-------------------------E-E-------------------------E-E-
----------------------------------------------------------------------------------------------------------------------------------------------------------------------------------------------------
-----------------XXXE------------------------XXXE------------------------XXXE------------------------XXXE------------------------XXXE------------------------XXXE------------------------XXXE-------
----------------------------------------------------------------------------------------------------------------------------------------------------------------------------------------------------
------------------------XXXX------------------------XXXX------------------------XXXX------------------------XXXX------------------------XXXX------------------------XXXX------------------------XXXX
-------------------------XXX-------------------------XXX-------------------------XXX-------------------------XXX-------------------------XXX-------------------------XXX-------------------------XXX
--E---E---E---E---E---E-E->---E---E---E---E---E---E-E->---E---E---E---E---E---E-E->---E---E---E---E---E---E-E->---E---E---E---E---E---E-E->---E---E---E---E---E---E-E->---E---E---E---E---E---E-E->-
----------------------------------------------------------------------------------------------------------------------------------------------------------------------------------------------------
-XXXXXXXXXXXXXXXXXXXXXXXXXXX-XXXXXXXXXXXXXXXXXXXXXXXXXXX-XXXXXXXXXXXXXXXXXXXXXXXXXXX-XXXXXXXXXXXXXXXXXXXXXXXXXXX-XXXXXXXXXXXXXXXXXXXXXXXXXXX-XXXXXXXXXXXXXXXXXXXXXXXXXXX-XXXXXXXXXXXXXXXXXXXXXXXXXXX
