---------------------------------------------------------------------------------------------------------------------------------------------------------------------------------------------------Q
---------------------------------------------------X---X--------------------------------------------------------------------------------------------------------------------------------------------
---------------------------------------SS--SS-SSS-SSS-SS---------------------------------------------------------------------------------------------------------------------Q]-------------------]Q
----------------------------------------------------------------------------------------------------------------------------------------------------------------------------------------------------
----------------------------------------X---X-X-X-X----X--------------------------------------------------------X---------------------------X------------------------------------------------------Q
----------------------------------------------SSS-S-SXSX--------------------------------------------------------------SSS-------------------S-------------------------------------------------------
-------------------------------------------------------S--------------------------------------------------------------S----------------------------------------------------------------------------Q
----------------------X-------------------------------------------X---------------------------------------X------------------------------------------------------XXX--------------------------------
------------------------------------------------------------------------------------------------------------------------------------------------------------------X---------------------------------
-----------------------------------------------------------------------------------------------------------------------------------------XXX-------------------------XXX----------------------------
]-------]-------------------]-------------------]-----------------------------------]----------------------------------------------------X-S-------------------------X-S----------------------------
-]-----------------------X---]]Q-------------]-Q------------X------------X-----------]-----------------------X---XXXX------------X------XXXX----------------XX------XXXX-XX------------------------Q
-----------------X----------]----------------------------X-X-X---X---X---X-------X-X----------------------------XX-X-X-----------X---X---X-X-X---------------X---X-X-X-X-X---X-----------X---------[
XXXXXXXXXXXXXXXXXXXXXXXXXXXXQXQQQXQXXXXXXXXXXXXXXXXXXXXXXXXXXXXXXXXXXXXXXXXXXXXXXXXXXXXXXXXXXXXXXXXXXXXXXXXXXXXXXXXXXXXXXXXXXXXXXXXXXXXXXXXXXXXXXXXXXXXXXXXXXXXXXXXXXXXXQXXXXXXXXXXXXXXXXXXXXXXXXXQ[
