----------------------------------------------------------------------------------------------------------------------------------------------------------------------------------------------------
----------------------------------------------------------------------------------------------------------------------------------------------------------------------------------------------------
----------------------------------------------------------------------------------------------------------------------------------------------------------------------------------------------------
----------------------------------------------------------------------------------------------------------------------------------------------------------------------------------------------------
----------------------------------------------------------------------------------------------------------------------------------------------------------------------------------------------------
-XXXXXXXXXXXXXXXXXXXXXXXX----XXXXXXXXXXXXXXXXXXXXXXXX----XXXX-XXXXXXXXXXXXXXXXXXX----XXXX-XXXXXXXXXXXXXXXXXXX----XXXXXXXXXXXXXXXXXXXXXXXX----XXXX-X-XXXXXXXXXXXXXXXXX----XXXXXXXXXXXXXXXXXXXXXXXX---
-X---X-X-X---X---X-X-X-X-----X---X-X-X---X---X-X-X-X-----X---X-X-X---X---X-X-X-X-----X---X-X-X---X---X-X-X-X-----X---X-X-X---X---X-X-X-X-----X---X-X-X---X---X-X-X-X-----X---X-X-X---X---X-X-X-X----
----------------------------------------------------------------------------------------------------------------------------------------------------------------------------------------------------
----------------------------------------------------------------------------------------------------------------------------------------------------------------------------------------------------
--X-X-X-------X---------------X-X-X-------X---------------X-X-X-------X---------------X-X-X-------X---------------X-X-X-------X---------------X-X-X-------X---------------X-X-X-------X-------------
-XXX-X-X-X-X-X-X-X-X-X-X-X-X-XXX-X-X-X-X-X-X-X-X-X-X-X-X-XXX-X-X-X-X-X-X-X-X-X-X-X-X-XXX-X-X-X-X-X-X-X-X-X-X-X-X-XXX-X-X-X-X-X-X-X-X-X-X-X-X-XXX-X-X-X-X-X-X-X-X-X-X-X-X-XXX-X-X-X-X-X-X-X-X-X-X-X-X
XXXXXXXXXXXXXXXXXXXXXXXXXXXXXXXXXXXXXXXXXXXXXXXXXXXXXXXXXXXXXXXXXXXXXXXXXXXXXXXXXXXXXXXXXXXXXXXXXXXXXXXXXXXXXXXXXXXXXXXXXXXXXXXXXXXXXXXXXXXXXXXXXXXXXXXXXXXXXXXXXXXXXXXXXXXXXXXXXXXXXXXXXXXXXXXXXXXX
XXXXXXXXXXXXXXXXXXXXXXXXXXXXXXXXXXXXXXXXXXXXXXXXXXXXXXXXXXXXXXXXXXXXXXXXXXXXXXXXXXXXXXXXXXXXXXXXXXXXXXXXXXXXXXXXXXXXXXXXXXXXXXXXXXXXXXXXXXXXXXXXXXXXXXXXXXXXXXXXXXXXXXXXXXXXXXXXXXXXXXXXXXXXXXXXXXXX
XXXXXXXXXXXXXXXXXXXXXXXXXXXXXXXXXXXXXXXXXXXXXXXXXXXXXXXXXXXXXXXXXXXXXXXXXXXXXXXXXXXXXXXXXXXXXXXXXXXXXXXXXXXXXXXXXXXXXXXXXXXXXXXXXXXXXXXXXXXXXXXXXXXXXXXXXXXXXXXXXXXXXXXXXXXXXXXXXXXXXXXXXXXXXXXXXXXX
