EEEEEEEEEEEEEEEEEEEEEEEEEEEEEEEEEEEEEEEEEEEEEEEEEEEEEEEEEEEEEEEEEEEEEEEEEEEEEEEEEEEEEEEEEEEEEEEEEEEEEEEEEEEEEEEEEEEEEEEEEEEEEEEEEEEEEEEEEEEEEEEEEEEEEEEEEEEEEEEEEEEEEEEEEEEEEEEEEEEEEEEEEEEEEEEEEEEE
----------------------------------------------------------------------------------------------------------------------------------------------------------------------------------------------------
EEEEEEEEEEEEEEEEEEEEEEEEEEEEEEEEEEEEEEEEEEEEEEEEEEEEEEEEEEEEEEEEEEEEEEEEEEEEEEEEEEEEEEEEEEEEEEEEEEEEEEEEEEEEEEEEEEEEEEEEEEEEEEEEEEEEEEEEEEEEEEEEEEEEEEEEEEEEEEEEEEEEEEEEEEEEEEEEEEEEEEEEEEEEEEEEEEEE
----------------------------------------------------------------------------------------------------------------------------------------------------------------------------------------------------
EEEEEEEEEEEEEEEEEEEEEEEEEEEEEEEEEEEEEEEEEEEEEEEEEEEEEEEEEEEEEEEEEEEEEEEEEEEEEEEEEEEEEEEEEEEEEEEEEEEEEEEEEEEEEEEEEEEEEEEEEEEEEEEEEEEEEEEEEEEEEEEEEEEEEEEEEEEEEEEEEEEEEEEEEEEEEEEEEEEEEEEEEEEEEEEEEEEE
-E-E-E-E-E-E-E-E-E-E-E-EXE-E-E-E-E-E-E-E-E-E-E-E-E-EXE-E-E-E-E-E-E-E-E-E-E-E-E-EXE-E-E-E-E-E-E-E-E-E-E-E-E-EXE-E-E-E-E-E-E-E-E-E-E-E-E-EXE-E-E-E-E-E-E-E-E-E-E-E-E-EXE-E-E-E-E-E-E-E-E-E-E-E-E-EXE-E
XEEEEEEEEEEEEEEEEEEEEEEEEEEEXEEEEEEEEEEEEEEEEEEEEEEEEEEEXEEEEEEEEEEEEEEEEEEEEEEEEEEEXEEEEEEEEEEEEEEEEEEEEEEEEEEEXEEEEEEEEEEEEEEEEEEEEEEEEEEEXEEEEEEEEEEEEEEEEEEEEEEEEEEEXEEEEEEEEEEEEEEEXEEEEEEEEEEE
XXXXXXXXXXXXXXXXXXXXXXXXXX-EXXXXXXXXXXXXXXXXXXXXXXXXXX-EXXXXXXXXXXXXXXXXXXXXXXXXXX-EXXXXXXXXXXXXXXXXXXXXXXXXXX-EXXXXXXXXXXXXXXXXXXXXXXXXXX-EXXXXXXXXXXXXXXXXXXXXXXXXXX-EXXXXXXXXXXXXXXXXXXXXXXXXXX-E
XXEXEXEXEXEEEEEXEXEXEEEEEXEEXXEXEXEXEXEEEEEXEXEXEEEEEXEEXXEXEXEXEXEEEEEXEXEXEEEEEXEEXXEXEXEXEXEEEEEXEXEXEEEEEXEEXXEXEXEXEXEEEEEXEXEXEEEEEXEEEXEXEXEXEXEEEEEXEXEXEEEEEXEEXXEXEXEXEXEEEEEXEXEXEEEEEXEE
XXXXXXXXXXXXXXXXXXXXXXXXXXXXXXXXXXXXXXXXXXXXXXXXXXXXXXXXXXXXXXXXXXXXXXXXXXXXXXXXXXXXXXXXXXXXXXXXXXXXXXXXXXXXXXXXXXXXXXXXXXXXXXXXXXXXXXXXXXXXXXXXXXXXXXXXXXXXXXXXXXXXXXXXXXXXXXXXXXXXXXXXXXXXXXXXXXXX
EEEEEXXXXXXXXXXEEEXXXXXXXXEEEEEEEXXXXXXXXXXEEEXXXXXXXXEEEEEEEXXXXXXXXXXEEEXXXXXXXXEEEEEEEXXXXXXXXXXEEEXXXXXXXXEEEEEEEXXXXXXXXXXEEEXXXXXXXXEEEEEEEXXXXXXXXXXEEEXXXXXXXXEEEEEEEXXXXXXXXXXEEEXXXXXXXXEE
-XEX-XXXXXXXXXXXXXXXXXXXXXXX-XEX-XXXXXXXXXXXXXXXXXXXXXXX-XEX-XXXXXXXXXXXXXXXXXXXXXXX-XEX-XXXXXXXXXXXXXXXXXXXXXXX-XEX-XXXXXXXXXXXXXXXXXXXXXXX-XEX-XXXXXXXXXXXXXXXXXXXXXXX-XEX-XXXXXXXXXXXXXXXXXXXXXXX
EXEXEXEXXXXXXXXXEXEXXXXXXXEEEXEXEXEXXXXXXXXXEXEXXXXXXXEEEXEXEXEXXXXXXXXXEXEXXXXXXXEEEXEXEXEXXXXXXXXXEXEXXXXXXXEEEXEXEXEXXXXXXXXXEXEXXXXXXXEEEXEXEXEXXXXXXXXXEXEXXXXXXXEEEXEXEXEXXXXXXXXXEXEXXXXXXXEE
XXXXXXXXXXXXXXXXXXXXXXXXXXXXXXXXXXXXXXXXXXXXXXXXXXXXXXXXXXXXXXXXXXXXXXXXXXXXXXXXXXXXXXXXXXXXXXXXXXXXXXXXXXXXXXXXXXXXXXXXXXXXXXXXXXXXXXXXXXXXXXXXXXXXXXXXXXXXXXXXXXXXXXXXXXXXXXXXXXXXXXXXXXXXXXXXXXXX
