----------------------------------------------------------------------------------------------------------------------------------------------------------------------------------------------------
----------------------------------------------------------------------------------------------------------------------------------------------------------------------------------------------------
----------------------------------------------------------------------------------------------------------------------------------------------------------------------------------------------------
----------------------------------------------------------------------------------------------------------------------------------------------------------------------------------------------------
------------------------------------------------------------------------------------XXX--------------------------------------------------------------------------------------------------------XS---
SS-----------------------------SSSSS---------------------------------------------------------------------------S-------SSS---------------------------------------------------------------------X----
---------------------E-XX----------EE-----------------------------------------------------XX------------------------------------------------------------------------------------------------XXXXXX--
XX-XXX----XXXX--------------------E----------------------------------------------------------------------------------------------------------------------------------------------------------XXXXX--
----------------E------S--------------S----------------------------------------------------S-------------------------Q-----------------------------------------------------------------------XXXXX--
S---------------X-------S-S----X-S-XXX----XXX--S------XX--------S-----------------------------------------------E----E---S----------------------------------------E-------------------------XXXX----
---------------XXX-------------E--------------------------------S---------------------------------------------------<>--------------------E----------------------<>------------------------XXXXX----
-------------------------X---------------------------[--------------------------------------------------------------[]-------------------------------------------[]------------------------XXXX-----
----E-------------------EX------------XX-------------[]----------------------E-------------]-E--E-E-----------------[]----------E--[---------------E-X-E--EX-----[]----------------------XXXXXX-----
X-----XXX-XXXX----XXXXXXXXXXXX---XXXX-XXXXXXXX----XXXX--XXXXXXXXXXXXXXXXXXXXXXXXXXXXXXXXXXXXXXXXXXXXXXXXXXXS----XXXXXXXXXXXXXXXXXXXXXXXXXXXXXXXXXXXXXXXXX-XXXXXXXXXXXXXXXXXXXXXXXXXXXXXXXXXXXXXXXXXX
