----------------------------------------------------------------------------------------------------------------------------------------------------------------------------------------------------
----------------------------------------------------------------------------------------------------------------------------------------------------------------------------------------------------
----------------------------------------------------------------------------------------------------------------------------------------------------------------------X-----------------------------
----------------------------------------------------------------------------------------------------------------------------------------------------------------------X-----------------------------
--------------------------------------X-------------------------------------------------------------------------------X---------------------[XX-X-----------------X-X-X-----------------------------
---------------------------------------------------------------------------------------------------------------------------------------------[--------------------S-S-------------------------------
------------------------------------------------------------------------------------------------------------------X-----------------X---------X-X-XXXXX---------------------------------------------
----------------------------------------------------------------------------------------------------------------------------------------------------------------------------------------------------
------------------------------X---X-------------------X-----------------------------------------------------------X---X---------------------------------------------------X-----------------------X-
------------S-S-S-S-S---------S---S-S-S-------------S-------------------------------------------------------------S-S-S-S-------------------------------------------------S-------------------------
----X--------XX---------------X---X-------------------------------------X-----------------------------------------X---X---------X------------------XX---------------------X-----------XXX-----------
--------------X-------------------X---------------X---X----------[-------[--------------------------------------------------------------------------------------------------------------[[--------X-
[[X-------XXXXXXXXS-----X[[[--XXXXXX------------XXX---XX---------[X------[[[-------X---------------------------X--SXXXX--------------------X-----XX[X-X-------------------XX---------[X[X[-----X-XXX
X[XXXXXXXXXXXXXXXXXXXXXXX[[[XXXXXXXXXXXXXXXXXXXXXXXXXXXXXXXXXXXXXXXXXXXXXXXXXXXXXXXXXXXXXXXXXXXXXXXXXXXXXXXXXXXXXXXXXXXXXXXXXXXXXXXXXXXXXXXXXXXXXXX[XXXXXXXXXXXXXXXXXXXXXXXXXXXXXXXXXXXXXXXXXXXXXXXX
