X?E>Q<Q>Q[EEE?E?E?E?E>Q>>>Q[>>SSSSSSSSSSSSSSSSSSSSSSSSSSX?E?E?E?E?E?E?E?E?E?E?E?E?EEX?E?EEEXE?E?E?E?E?E?EXQ>>>Q[>>SSSSSSSSSSSSSSSSSSSSSSSSSSX>>>SSSSSQQ[[[EXE<Q>>>SSSSSSX?E?E?EXE?E?E?E?E?E?E?E?EXE[
XXE]]>]]]>EXEXEXEXEXE]]>]>S>]SSSSSSSSSSSSSSSSSSSSSSSSSSSXXEXEXEXEXEXEXEXEXEXEXEXEXE?XXEXEX-X-XEXEXEXEXEXEX]>]]<>]SSSSSSSSSSSSSSSSSSSSSSSSSSS]>]]SSSSSSS>S>-XE]]>SSSSSSSSXXEXEXEXEXEXEXEXEXEXEXEXEXEX
X-]>]>]>>>EXEXEXEXEXE>]>>QS<SSSSSSSSSSSSSSSSSSSSSSSSSSSSXXEXEXEXEXEXEXEXEXEXEXEXEXEEXXEXE-E--XEXEXEXEXEXE-]>><S<SSSSSSSSSSSSSSSSSSSSSSSSSSSS>>>SSSSSSSS<>>--E>]>SSSSSSSSXXEXEXEXEXEXEXEXEXEXEXEXEXE-
]]]>]><>]XEXEXEXEXEXE]]]]>SSSSSSSSSSSSSSSSSSSSSSSSSSSSSSXXEXEXEXEXEXEXEXEXEXEXEXEXEXXXEXEXEXEXEXEXEXEXEXEX]]]><>SSSSSSSSSSSSSSSSSSSSSSSSSSSS]>SSSSSSSSS>[>EXE>]]SSSSSSSSXXEXEXEXEXEXEXEXEXEXEXEXEXEX
>>]>>>>>>>--EXEXEXE-]>]>><S<SSSSSSSSSSSSSSSSSSSSSSSSSSSSXXEXEXEXEXEXEXEXEXEXEXEXEXEEXXEXEEE-EXEXEXEXEXEXE>]>>><<SSSSSSSSSSSSSSSSSSSSSSSSSSSS>SSSSSSSSSS>>>]-]>]<SSSSSSSSXXEXEXEXEXEXEXEXEXEXEXEXEXEE
]>]><><><>]XEXEXEXEX]]]>]]<>SSSSSSSSSSSSSSSSSSSSSSSSSSSSXXEXEXEXEXEXEXEXEXEXEXEXEXE?XXEXE>EXEXEXEXEXEXEXEX]>]]<>SSSSSSSSSSSSSSSSSSSSSSSSSSSS]SSSSSSSSSSSS>]>]]]<SSSSSSSSXXEXEXEXEXEXEXEXEXEXEXEXEXEX
]>>>><>>><[--XEXEXE-]>]>>SS<SSSSSSSSSSSSSSSSSSSSSSSSSSSSXXEXEXEXEXEXEXEXEXEXEXEXEXEEXXE>]>]-EXEXEXEXEXEXE-]>]<S<SSSSSSSSSSSSSSSSSSSSSSSSSSSSSSSSSSSSSSS<>>]>]>SSSSSSSSSSXXEXEXEXEXEXEXEXEXEXEXEXEXEE
]>]>]><>S>[XEXEXEXEX]>]>]>S>SSSSSSSSSSSSSSSSSSSSSSSSSSSSXXEXEXEXEXEXEXEXEXEXEXEXEXEXXXE>]>]X-XEXEXEXEXEXEX]]]>S>SSSSSSSSSSSSSSSSSSSSSSSSSSSSSSSSSSSSSSS><>]>]]SSSSSSSSSSXXEXEXEXEXEXEXEXEXEXEXEXEXEX
]>>>><>>><[XEXEXEXE-]>]>QSS<SSSSSSSSSSSSSSSSSSSSSSSSSSSSXXEXEXEXEXEXEXEXEXEXEXEXEXEEX-E>]>]>EEEXEXEXEXEXEX]<>>Q<SSSSSSSSSSSSSSSSSSSSSSSSSSSSSSSSSSSSSSS<>>>>]>SSSSSSSSSSXXEXEXEXEXEXEXEXEXEXEXEXEXEE
]>]]]>]><>-XEXEXEXEX]]]><><>SSSSSSSSSSSSSSSSSSSSSSSSSSSSXXEXEXEXEXEXEXEXEXEXEXEXEXE?XXE]]>]>EXEXEXEXEXEXEX]>]><>SSSSSSSSSSSSSSSSSSSSSSSSSSSSSSSSSSSSSSS>]>]>]]SSSSSSSSSSXXEXEXEXEXEXEXEXEXEXEXEXEXEX
]>>>>>>>>>-XEXEXEXE-]>>>>QS<SSSSSSSSSSSSSSSSSSSSSSSSSSSSXXEXEXEXEXEXEXEXEXEXEXEXEXEE--E>]>]>--EXEXEXEXEXEXE>]>><SSSSSSSSSSSSSSSSSSSSSSSSSSSSSSSSSSSSSSS>>>>>><SSSSSSSSSSXXEXEXEXEXEXEXEXEXEXEXEXEXEE
]>]>]><>S>-XEXEXEXEX]]]>]><>SSSSSSSSSSSSSSSSSSSSSSSSSSSSXXEXEXEXEXEXEXEXEXEXEXEXEXEXXXEX]>]>[XEXEXEXEXEXEXE>]><>SSSSSSSSSSSSSSSSSSSSSSSSSSSSSSSSSSSSSSS>]><>S>SSSSSSSSSSXXEXEXEXEXEXEXEXEXEXEXEXEXEX
]<]]]<><>>>-EXEXEXE-]]]]><<<SSSSSSSSSSSSSSSSSSSSSSSSSSSSXXEXEXEXEXEXEXEXEXEXEXEXEXE-]>]]]]]>]-EXEXEXEXEXE-E]]]><SSSSSSSSSSSSSSSSSSSSSSSSSSSSSSSSSSSSSS>]><><S<SSSSSSSSSSXXEXEXEXEXEXEXEXEXEXEXEXEXE-
]]]]]]]]>>S---------]]]]]]>>SSSSSSSSSSSSSSSSSSSSSSSSSSSS----------------------------]]]]]]]]]--------------]]]]>SSSSSSSSSSSSSSSSSSSSSSSSSSSS]]]>]]S>S>]]]]]]]]]]]]SSSSSS----------------------------
